11111111111111111
10000000000C000C1
10100101000010011
10100000011000011
100001000C0000001
1001000P0100100C1
10100100010001011
1010C001010100011
10100001000001011
11111111111111111
