1111111
100R001
1P010C1
10CR0E1
1111111
