1111111111111
11111P11111C1
1000001000101
10111010R0C01
1C10000001101
1R00111100001
1010111100111
101R011C00001
10C1011111001
11110000C10E1
1111111111111
