11111111111111111
1E00R000000C000C1
10100101000010011
10100000011000011
100001000C00R0001
1001000P0100100C1
10100100010001011
1010C001010100011
1010R0010R0001011
11111111111111111
